###################
#=================#
#=============#===#
#=====@=======#===#
#=============#===#
#===========@=#===#
#====@=====@==#===#
#======#======#===#
#===@=##===@==#===#
#######==========##
######============#
#@==========@=====#
###################